11111111111111111111
1P..M1.............1
1111.1....1111.....1
1....1.............1
1.11.1.............1
1.1..1.............1
1.1.11.......1111..1
1..................1
1....M.............1
1..................1
1.............11M1.1
1.......1111...11111
1.........M....1...1
1..............1..11
1..............1.111
11111111111111111111