*.******************
.PMSG*.............*
****.*....****.....*
*....*.............*
*.**.*.............*
*.*..*.............*
*.*.**.......****..*
*..................*
*....M.............*
*..................*
*.............**G*.*
*.......****...*****
*.........M....*...*
*..............*..**
*..............*.***
*.******************